--table layout
local layout = {
	{
		{15, 21, 21, 21, 21, 21, 21, 21, 21, 21, 21, 21, 21, 21, 21, 21, 21, 21, 21, 21, 21, 21, 21, 21, 21, 21, 21, 21, 21, 21, 21, 21, 21, 21, 15},
		{16, 17,  1,  1,  1,  1,  1,  1,  1,  1,  1,  1,  1,  1,  1,  1,  1,  1,  1,  1,  1,  1,  1,  1,  1,  1,  1,  1,  1,  1,  1,  1,  1,  1, 14},
		{16, 17,  1,  1,  1,  1,  1,  1,  1,  1,  1,  1,  1,  1,  1,  1,  1,  1,  1,  1,  1,  1,  1,  1,  1,  1,  1,  1,  1,  1,  1,  1,  1,  1, 14},
		{16, 17,  1,  1,  1,  1,  1,  1,  1,  1,  1,  1,  1,  1,  1,  1,  1,  1,  1,  3,  3,  3,  3,  3,  3, 12,  1,  1,  1,  1, 24,  1,  1,  1, 14},
		{16, 17,  1,  1,  2,  3,  1,  1,  1,  1,  1,  1,  1, 24,  3,  3,  3,  3, 27,  9,  9,  9,  9,  9,  9, 18,  1,  1,  1,  1, 30, 36, 36, 36, 15},
		{16, 17,  1,  7,  8,  9, 28,  1,  1,  1,  1,  1,  1, 30,  9,  9,  9,  9, 33, 21, 21, 21, 21, 15, 16, 17, 27, 10, 11,  1,  1,  1,  1,  1, 14},
		{16, 17,  1,  1, 14, 15, 34, 28,  3,  3,  1,  1,  1,  1, 20, 21, 21, 21, 22,  1,  1,  1,  1, 20,  6,  9, 33, 16, 17,  1,  1,  1,  1,  1, 14},
		{16, 17,  1,  1, 14, 15, 15, 34,  9,  9, 28,  1,  1,  1, 26,  1,  1,  1,  1,  1,  1,  1,  1, 26, 20, 21,  5, 15, 10, 11,  1,  1,  1,  1, 14},
		{16, 17,  1,  1, 14, 15, 15, 15, 15, 15, 34, 28,  1,  1,  1,  1,  1,  1,  1,  1,  1,  1,  1,  1, 26,  1, 20, 15, 16, 17,  1,  1,  1,  1, 14},
		{16, 17,  1,  1, 14, 15, 15, 15, 15, 15, 15, 34,  1,  1,  1,  1,  1,  1,  1,  1,  1,  1,  1,  1,  1,  1, 26, 14, 15, 28, 12,  1,  1,  1, 14},
		{16, 17,  1,  1, 14, 15, 15, 15, 15, 15, 15, 15, 28,  1,  1,  1,  1,  1,  1,  1,  1,  1,  1,  1,  1,  1,  1, 14, 15, 34, 18,  1,  1,  1, 14},
		{16, 17,  1,  1, 14, 15, 15, 15, 15, 15, 15, 15, 34, 28,  7,  8, 28, 27, 28,  3,  3,  1,  1,  1,  1,  1,  1, 14, 15, 22,  1,  1,  1, 24, 14},
		{16, 17,  1,  1, 14, 15, 15, 15, 15, 15, 15, 15, 15, 34,  1, 14, 34, 33, 34,  9,  9, 28,  1,  1,  1,  1,  1, 14, 16, 17,  1,  1,  1, 30, 15},
		{16, 17,  1,  1, 14, 15, 15, 15, 15, 15, 15, 15, 15, 16, 17, 14, 15, 15, 15, 15,  6, 34,  1,  1,  2,  3,  3, 14, 16, 17,  1,  1,  1,  1, 14},
		{16, 17,  1,  1, 14, 15, 15, 15, 15, 15, 15, 15, 15, 16, 17, 20, 15, 15, 15, 15, 15, 16, 17,  7,  8,  9,  9,  6, 15,  9, 28,  3,  1,  1, 14},
		{16, 17,  1,  1, 14, 15, 15, 15, 15, 15, 15, 15, 21, 22,  1, 26, 20, 15, 15,  5, 15, 22,  1,  1, 20, 21, 21, 15, 15, 15, 34,  9, 28,  1, 14},
		{16, 17,  1,  1, 14, 15, 15, 15, 15, 21, 21, 22,  1,  1,  1,  1, 26, 20, 21, 21, 22,  1,  1,  1, 26,  1,  1, 14, 15, 15, 15, 15, 34, 28, 14},
		{16, 17,  1,  1, 14, 15, 15, 15, 22,  1,  1,  1,  1,  1,  1,  1,  1, 26,  1,  1,  1,  1,  1,  1,  1,  1,  1, 20, 15, 15, 15, 15,  6, 34, 15},
		{16, 17,  1,  1, 14, 15, 15, 16, 17,  1,  1,  1,  1,  1,  1,  1,  1,  1,  1,  1,  1,  1,  1, 24, 12,  1,  1, 26, 14, 15, 15, 15, 15, 15, 15},
		{16, 17,  1,  1, 14, 15, 15, 16, 17,  1,  1,  1,  1,  1,  1,  1,  1,  1,  1,  1,  4,  1,  1, 30, 18,  1,  1,  1, 20, 21,  5, 15, 15, 15, 15},
		{16, 17,  1,  1, 14, 15, 15, 16, 17,  1,  1,  1,  1,  1,  1,  1,  1,  1,  1, 27, 10, 11,  1,  1,  1,  1,  1,  1, 26,  1, 20,  6, 15, 15, 15},
		{16, 17,  1,  1, 14, 15, 15, 16, 17,  1,  1,  1,  1,  1,  1,  1,  1,  1, 27, 33, 16, 17,  1,  1,  1,  1,  1,  1,  1,  1, 26, 20, 15,  5, 15},
		{16, 17,  1,  1, 14, 15, 15, 16, 17,  1,  1,  1,  1,  2, 27,  9,  9,  9, 33, 15, 16, 17, 12, 24,  1, 12,  1,  1,  1,  1,  1, 26, 14, 15, 15},
		{16, 17,  1,  1, 14, 15, 15, 16, 17,  1,  1,  1,  7,  8, 33, 15, 15, 15, 15, 15, 15,  9, 18, 30, 36, 18,  1,  1,  1,  1,  1,  1, 14, 15, 15},
		{16, 17,  1,  1, 14, 15, 15,  6, 28,  1,  1,  1,  1, 14, 15, 15, 15, 15, 15, 15, 15, 16, 17,  1,  1,  1,  1,  1,  1,  1,  1,  1, 14, 15, 15},
		{16, 17,  1,  1, 14, 15, 15, 15, 34,  1,  1,  2,  3, 14, 15, 15, 15, 15, 15, 15, 15, 16, 17,  1,  1,  1,  1, 24,  1,  1, 12,  1, 14, 15, 15},
		{16, 17,  1,  1, 14, 15, 15, 15, 16, 17,  7,  8,  9, 15, 15, 15, 15, 15, 15, 15, 15, 16, 17,  1,  1,  1,  1, 30, 36, 36, 18,  1, 14, 15, 15},
		{16, 17,  1,  1, 14, 15, 15, 15, 16, 17,  1, 14, 15, 15, 15, 15, 15, 15,  6, 21, 21, 22,  1,  1,  1,  1,  1,  4,  1,  1,  1,  1, 14, 15, 15},
		{16, 17,  1,  1, 14, 15, 21, 21, 22,  1,  1, 20, 21, 21, 15, 15, 15, 15, 16, 17,  1,  1,  1,  1,  1,  1, 27, 10, 11,  1,  1,  1, 14, 15, 15},
		{16, 17,  1,  1, 14, 16, 17,  1,  1,  1,  1, 26,  1,  1, 20, 21, 21, 21, 22,  1,  1,  1,  1,  1,  1, 27, 33, 16,  3,  3,  3, 27, 15, 15, 15},
		{16, 17,  1,  1, 14, 16, 17,  1,  1,  1,  1,  1,  1,  1, 26,  1,  1,  1,  1,  1,  1,  1,  1,  1, 27, 33,  5, 15,  9,  9,  9, 33, 15, 15, 15},
		{16, 17,  1,  1, 14, 16, 17,  1,  1,  1,  1,  1,  1,  1,  1,  1,  1,  1,  1,  1,  1,  1,  1,  1, 33, 15, 15, 15, 15, 15, 15, 15, 15, 15, 15},
		{16, 17,  1,  1, 14, 16, 17,  1,  1,  1,  1,  1,  1,  1,  1,  1,  1,  1,  1,  1,  1, 24,  1, 12, 14, 15, 15, 15, 15, 15, 15, 15, 15, 15, 15},
		{16, 17,  1,  1, 14, 15, 28,  3,  1,  1,  1,  1,  1,  1,  1,  1,  1,  1,  1,  1,  1, 30, 36, 18, 14, 15, 15, 15, 15, 15, 15, 21, 21,  6, 15},
		{16, 17,  1,  1, 14, 15, 34,  9, 28,  3,  3,  1,  1,  1,  2,  3,  1,  1,  1,  1,  1,  1,  1,  1, 14, 15, 15, 15, 15, 15, 16, 17,  1, 20,  5},
		{16, 17,  1,  1, 14, 15, 15, 15, 34,  9,  9, 28,  1,  1,  8,  9, 28,  3,  1,  1,  1,  1,  1,  1, 14, 15, 15, 15, 15, 15, 16, 17,  1,  1, 14},
		{16, 17,  1,  1, 14, 15, 15, 15, 15, 15, 15, 34,  1,  1, 14, 15, 34,  9, 28,  1,  1,  1,  1,  1, 20, 21, 21,  6, 15, 15, 16, 17,  1,  1, 14},
		{16, 17,  1,  1, 14, 15, 15, 21, 21, 21, 15, 16, 17,  1, 14, 15, 15, 15, 34, 12,  1,  1,  1,  1, 26,  1,  1, 14, 15, 15, 21, 18,  1,  1, 14},
		{16, 17,  1,  1, 20, 21, 22,  1,  1,  1, 20, 22,  1,  1, 20, 21, 21, 21, 21, 18,  1,  1,  1,  1,  1,  1,  1, 20, 21, 22,  1,  1,  1,  1, 14},
		{16, 17,  1,  1, 26,  1,  1,  1,  1,  1, 26,  1,  1,  1, 26,  1,  1,  1,  1,  1,  1,  1,  3, 12,  1,  1,  1, 26,  1,  1,  1,  1,  1,  1, 14},
		{ 6, 28,  3,  1,  1,  1,  1,  1,  3,  1,  1,  1,  1,  1,  1,  1,  1,  1,  1,  1,  1, 27,  9, 18,  1,  1,  1,  1,  1,  1,  1,  1,  1,  1, 14},
		{15, 34,  9, 28,  3,  3,  3, 27,  9, 28,  3,  3,  3,  3,  3,  3,  3,  3,  3,  3, 27, 33, 16, 17,  3,  3,  3,  3,  3,  3,  3,  3,  3,  3, 14},
		{15, 15, 15, 34,  9,  9,  9, 33, 15, 34,  9,  9,  9,  9,  9,  9,  9,  9,  9,  9, 33, 15,  5,  9,  9,  9,  9,  9,  9,  9,  9,  9,  9,  9, 15}
	}
}
--string tileset
local tileset = "tileset/example.tset"
--table dynamic
local dynamic = {}
--table environment
local environment = {
	oc = 1,
	friction = 1000,
	gravity = 800,
	tileSize = 16,
	background = "spr/bgtemp.png"
}
--string name
local name = "Test Map"
--table entities
local entity = {
	{type = "player", sprite = "spr/fullsuit.spr", posX = 30, posY = 36}
}

return { layout, tileset, dynamic, environment, name, entity }
