return {
	--table layout
	{{}, {
		{15, 15, 15, 15, 15, 15, 15, 15, 15, 15, 15, 15, 15, 15, 15, 15, 15, 15, 15, 15},
		{15,  1,  1,  1,  1,  1,  1,  1,  1,  1,  1,  1,  1,  1,  1,  1,  1,  1,  1, 15},
		{15,  1,  1,  1,  1,  1,  1,  1,  1,  1,  1,  1,  1,  1,  1,  1,  1,  1,  1, 15},
		{15,  1,  1,  1,  1,  1,  1,  1,  1,  1,  1,  1,  1,  1,  1,  1,  1,  1,  1, 15},
		{15,  1,  1,  1,  1,  1,  1,  1,  1,  1,  1,  1,  1,  1,  1,  1,  1,  1,  1, 15},
		{15,  1,  1,  1,  1,  1,  1,  1,  1,  1,  1,  1,  1,  1,  1,  1,  1,  1,  1, 15},
		{15,  1,  1,  1,  1,  1,  1,  1,  1,  1,  1,  1,  1,  1,  1,  1,  1,  1,  1, 15},
		{15,  1,  1,  1,  1,  1,  1,  1,  1,  1,  1,  1,  1,  1,  1,  1,  1,  1,  1, 15},
		{15,  1,  1,  1,  1,  1,  1,  1,  1,  1,  1,  1,  1,  1,  1,  1,  1,  1,  1, 15},
		{15,  1,  1,  1,  1,  1,  1,  1,  1,  1,  1,  1,  1,  1,  1,  1,  1,  1,  1, 15},
		{15,  1,  1,  1,  1,  1,  1,  1,  1,  1,  1,  1,  1,  1, 15,  1,  1,  1,  1, 15},
		{15,  1,  1,  1,  1,  1,  1,  1,  1,  1,  1,  1, 15, 15,  1,  1,  1,  1,  1, 15},
		{15,  1,  1,  1,  1,  1,  1,  1,  1,  1,  1,  1,  1,  1,  1,  1,  1,  1,  1, 15},
		{15,  1,  1,  1,  1,  1, 15, 28,  1,  1,  1,  1,  1,  1,  1,  1,  1,  1,  1, 15},
		{15, 15, 15, 15, 15, 15, 15, 15, 15, 15, 15, 15, 15, 15, 15, 15, 15, 15, 15, 15}
	}, {}},
	--string tileset
	"tileset/example.tset",
	--table dynamic
	{},
	--table environment
	{
		oc = 2,
		friction = 1000,
		gravity = 800,
		tileSize = 16
	},
	--string name
	"Test Map"
}